6 6 6 6 6 6 6 6 6 6 6 6 6 6 6 6 7 7 7 7 7 7 7 7 7 7 7 7 7 7 7 7 7 4 6 6 6 6 6 6 6 6 6 6 6 6 6 6 6 6
6 9 9 9 9 9 9 9 9 9 9 9 9 9 0 3 7 7 7 7 7 7 7 7 7 7 7 7 7 7 7 7 7 4 6 1 1 1 1 1 6 4 6 1 1 1 1 1 1 6
6 9 9 9 9 9 9 9 9 9 9 9 9 9 0 3 3 3 3 3 3 3 3 3 3 3 3 3 3 3 3 3 3 3 6 1 1 1 1 1 6 4 6 1 1 1 1 1 1 6
6 9 9 9 9 9 9 9 9 9 9 9 9 9 0 3 7 7 7 7 7 7 7 7 7 7 7 7 7 7 7 7 7 3 6 1 1 1 1 1 6 4 6 1 1 1 1 1 1 6
6 9 9 9 9 9 9 9 9 9 9 9 9 9 0 3 7 7 7 7 7 7 7 7 7 7 7 7 7 7 7 7 7 3 6 6 3 6 6 6 6 4 6 3 6 6 6 6 6 6
6 9 9 9 9 9 9 9 9 9 9 9 9 9 0 3 3 3 3 3 3 3 3 3 3 3 3 3 3 3 3 3 3 3 3 3 3 3 3 3 3 3 3 3 3 3 3 3 3 6
6 9 9 9 9 9 9 9 9 9 9 9 9 9 0 3 8 8 2 2 2 2 2 2 2 8 8 8 8 8 2 2 2 2 2 2 8 8 3 4 4 3 6 6 6 6 6 6 6 6
6 9 9 9 9 9 9 9 9 9 9 9 9 9 0 3 8 8 8 2 2 2 2 2 8 8 2 8 2 8 8 2 2 2 2 8 8 8 3 4 4 3 6 1 1 1 1 1 1 6
6 9 9 9 9 9 9 9 9 9 9 9 9 9 0 3 2 2 8 8 2 2 2 8 8 2 2 8 2 2 8 8 2 2 8 8 2 2 3 4 4 3 3 1 1 1 1 1 6 6
6 9 9 9 9 9 9 9 9 9 9 9 9 9 0 3 2 2 2 8 8 8 8 8 2 2 8 8 8 2 2 8 8 8 8 2 2 2 3 4 4 3 6 6 6 6 6 6 6 6
6 9 9 9 9 9 9 9 9 9 9 9 9 9 0 3 2 2 2 2 8 8 8 8 8 8 8 8 8 8 8 8 8 8 8 2 2 2 3 4 4 3 3 3 3 3 3 3 3 6
6 9 9 9 9 9 9 9 9 9 9 9 9 9 0 3 2 2 2 8 8 8 8 8 2 2 8 8 8 2 2 8 8 8 8 2 2 2 3 4 4 3 6 6 6 6 6 6 6 6
6 9 9 9 9 9 9 9 9 9 9 9 9 9 0 3 2 2 8 8 2 2 2 8 8 2 2 8 2 2 8 8 2 2 8 8 2 2 3 4 4 3 1 1 1 1 1 0 6 6
6 9 9 9 9 9 9 0 0 0 0 0 0 0 0 3 8 8 8 2 2 2 2 2 8 8 2 8 2 8 8 2 2 2 2 8 8 8 3 4 4 3 6 6 6 6 6 6 6 6
6 0 0 0 0 0 0 0 0 0 0 0 0 0 0 3 8 8 2 2 2 2 2 2 2 8 8 8 8 8 2 2 2 2 2 2 8 8 3 3 3 3 3 3 3 3 3 3 3 6
6 3 3 3 3 3 3 3 3 3 3 3 3 3 3 3 4 4 4 4 4 4 4 4 4 4 4 4 4 4 4 4 4 4 4 4 4 4 3 4 4 4 4 6 3 6 6 6 6 6
6 2 2 2 2 2 2 2 2 2 2 2 2 2 2 3 3 3 3 3 3 3 3 3 3 3 3 3 3 3 3 3 3 3 4 4 4 4 3 4 4 4 4 6 1 1 1 1 6 6
6 3 3 2 2 2 2 2 2 2 2 2 2 2 3 3 3 3 3 3 3 3 3 3 3 3 3 3 3 3 3 3 3 3 4 4 4 4 3 4 4 4 4 6 1 1 1 1 6 6
6 4 4 3 2 2 2 2 2 2 2 2 2 2 2 3 5 5 5 5 5 5 5 5 3 5 5 5 5 5 5 5 5 3 4 4 4 4 3 4 4 4 3 6 6 6 6 6 6 6
6 4 4 3 2 2 2 2 2 2 2 2 2 2 2 3 5 5 5 2 2 2 2 2 2 2 2 2 2 2 5 5 5 3 4 4 4 4 3 5 5 5 5 3 3 3 3 3 3 6
6 4 4 3 2 2 2 2 2 2 2 2 2 2 2 3 5 5 5 2 2 2 2 2 2 2 2 2 2 2 5 5 5 3 4 4 4 4 3 5 5 5 5 3 6 6 6 6 6 6
6 4 4 3 2 2 2 2 2 2 2 2 2 2 2 3 5 5 5 2 2 2 2 2 2 2 2 2 2 2 5 5 5 3 4 4 4 4 3 5 5 5 5 3 6 1 1 1 6 6
6 3 3 3 2 2 2 2 2 2 2 2 2 2 2 3 5 5 5 2 2 2 2 2 2 2 2 2 2 2 5 5 5 3 4 4 4 4 3 5 5 5 5 3 6 1 1 1 6 6
6 4 4 3 2 2 2 2 2 2 2 2 2 2 2 3 5 5 5 2 2 2 2 2 2 2 2 2 2 2 5 5 5 3 4 4 4 4 3 5 5 5 5 3 6 1 1 1 6 6
6 4 4 3 2 2 2 2 2 2 2 2 2 2 2 3 5 5 5 2 2 2 2 2 2 2 2 2 2 2 5 5 5 3 4 4 4 4 3 5 5 5 5 3 3 1 1 1 6 6
6 4 4 3 2 2 2 2 2 2 2 2 2 2 2 3 3 3 3 2 2 2 2 2 2 2 2 2 2 2 3 3 3 3 3 3 3 3 3 5 5 5 5 3 6 1 1 1 6 6
6 4 4 3 2 2 2 2 2 2 2 2 2 2 2 3 5 5 5 2 2 2 2 2 2 2 2 2 2 2 5 5 5 3 4 4 4 4 3 5 5 5 5 3 6 1 1 1 6 6
6 3 3 3 2 2 2 2 2 2 2 2 2 2 2 3 5 5 5 2 2 2 2 2 2 2 2 2 2 2 5 5 5 3 4 4 4 4 3 5 5 5 5 3 3 1 1 1 6 6
6 4 4 3 2 2 2 2 2 2 2 2 2 2 2 3 5 5 5 2 2 2 2 2 2 2 2 2 2 2 5 5 5 3 4 4 4 4 3 5 5 5 5 3 6 6 6 6 6 6
6 4 4 3 2 2 2 2 2 2 2 2 2 2 2 3 5 5 5 2 2 2 2 2 2 2 2 2 2 2 5 5 5 3 4 4 4 4 3 3 3 3 3 3 3 3 3 3 3 6 
6 4 4 3 2 2 2 2 2 2 2 2 2 2 2 3 5 5 5 5 5 5 5 5 3 5 5 5 5 5 5 5 5 3 4 4 4 4 3 4 4 4 4 4 3 0 0 0 0 6
6 4 4 3 2 2 2 2 2 2 2 2 2 2 2 3 5 5 5 5 5 5 5 5 3 5 5 5 5 5 5 5 5 3 4 4 4 4 3 4 4 4 4 4 3 0 8 8 8 6
6 3 3 3 3 3 3 3 3 3 3 3 3 3 3 3 5 5 5 5 5 5 5 5 3 5 5 5 5 5 5 5 5 3 4 4 4 4 3 4 4 4 4 4 3 0 8 8 8 6
6 4 4 4 4 4 4 4 4 4 4 4 4 4 4 3 3 3 3 3 3 3 3 3 3 3 3 3 3 3 3 3 3 3 3 3 3 3 3 3 3 3 3 3 3 0 0 0 0 6
6 3 4 3 3 3 4 4 4 4 4 3 3 3 4 4 4 3 4 4 3 6 6 3 6 6 6 6 3 6 6 3 6 6 6 6 3 6 6 3 6 6 6 6 3 0 8 8 8 6
6 3 3 3 4 3 4 3 3 3 3 3 4 3 3 3 3 3 3 3 3 6 1 1 1 1 1 6 3 6 1 1 1 1 1 6 3 6 1 1 1 1 1 6 3 8 8 8 8 6
6 3 4 4 4 3 3 3 4 4 4 4 4 4 4 4 4 4 4 4 3 6 1 1 1 1 1 6 3 6 1 1 1 1 1 6 3 6 1 1 1 1 1 6 3 3 3 3 0 6
6 3 7 7 7 7 7 7 7 7 7 7 7 7 7 7 7 7 7 7 3 6 1 1 1 1 1 6 3 6 1 1 1 1 1 6 3 6 1 1 1 1 1 6 3 8 8 8 8 6
6 4 7 7 7 7 7 7 7 7 7 7 7 7 7 7 7 7 7 7 3 6 1 1 1 1 1 6 3 6 1 1 1 1 1 6 3 6 1 1 1 1 1 6 3 0 0 0 0 6
6 3 3 3 3 3 3 3 3 3 3 3 3 3 3 3 3 3 3 3 3 6 1 1 1 1 1 6 3 6 1 1 1 1 1 6 3 6 1 1 1 1 1 3 3 0 8 8 8 6
6 3 7 7 7 7 7 7 7 7 7 7 7 7 7 7 7 7 7 7 3 6 1 1 1 1 1 3 3 6 1 1 1 1 1 6 3 6 1 1 1 1 1 6 3 0 0 0 0 6
6 3 7 7 7 7 7 7 7 7 7 7 7 7 7 7 7 7 7 7 3 6 6 6 6 6 6 6 3 6 6 6 3 6 6 6 3 6 6 6 6 6 6 6 3 0 8 8 8 6
6 4 4 3 3 3 3 3 3 3 3 4 4 4 4 4 4 4 4 4 3 3 3 3 3 3 3 3 3 3 3 3 3 3 3 3 3 3 3 3 3 3 3 3 3 0 8 8 8 6
6 3 3 3 4 4 4 4 4 4 3 3 3 3 3 3 4 4 4 4 4 4 4 4 4 4 4 4 4 4 4 4 3 8 8 3 8 8 3 1 1 3 8 8 3 0 2 2 2 6
6 4 4 4 4 4 4 4 4 4 4 4 4 4 4 3 3 3 3 3 4 4 4 3 3 3 3 4 3 3 3 3 3 8 8 3 8 8 3 1 1 3 8 8 3 0 0 0 0 6
6 3 3 3 3 4 4 4 3 3 3 3 3 3 3 3 4 4 4 3 3 3 3 3 4 4 3 3 3 4 3 4 3 8 8 3 8 8 3 1 1 3 8 8 3 0 8 8 8 6
6 4 4 4 3 4 4 4 3 4 4 4 4 4 4 4 4 4 4 4 4 4 4 4 4 4 4 4 4 4 3 4 3 8 8 3 8 8 3 1 1 3 8 8 3 0 8 8 8 6
6 3 3 3 3 3 3 3 3 3 3 3 3 3 3 3 3 3 3 3 3 3 3 3 3 3 3 4 3 3 3 4 3 8 8 3 8 8 3 1 1 3 8 8 3 0 0 0 0 6
6 6 6 6 6 6 6 6 6 6 6 6 6 6 6 6 6 6 6 6 6 6 6 6 6 6 3 4 3 3 4 4 3 8 8 3 8 8 3 1 1 3 8 8 3 0 8 8 8 6
6 6 6 6 6 6 6 6 6 6 6 6 6 6 6 6 6 6 6 6 6 6 6 6 6 6 6 6 6 6 6 6 6 6 6 6 6 6 6 6 6 6 6 6 6 6 6 6 6 6
